alias k=kubectl
#Kube Config Specific clusters, users and their context
alias kco="kubectl config use-context"
alias context="kubectl config get-contexts"
alias kn="kubectl config set-context --current --namespace"
alias kdes="kubectl describe"
alias kdesp="kubectl describe po"
alias kdesd="kubectl describe deploy"
alias kg="kubectl get"
alias kgp="kubectl get pods"
#As a specific user
alias kgpas="kubectl get pods --as"
alias kgpw="kubectl get pod --watch"
alias kgd="kubectl get deploy"
alias kgrs="kubectl get replicaset"
alias kgds="kubectl get daemonset"
alias kge="kubectl get events"
alias kgeo="kubectl get events -o wide"
alias kgn="kubectl get nodes --show-labels=true"
alias kgcm="kubectl get cm"
alias kgs="kubectl get secret"
#App Lifecycle Specific
alias krrs="kubectl rollout restart sts"
alias krrd="kubectl rollout restart deploy"
alias krsd="kubectl rollout status deploy"
alias krhd="kubectl rollout history deploy"
alias krud="kubectl rollout undo deploy"
alias kpd="kubectl patch deployment"
alias ks="kubectl scale --replicas="
alias kl="kubectl logs"
alias klf="kubectl logs -f"
alias klfp="kubectl logs -f --previous"
alias kc="kubectl create"
alias kcd="kubectl create deploy"
alias kd="kubectl delete"
alias kedit="kubectl edit"
alias ke="kubectl expose"
alias ked="kubectl expose deployment"
alias kep="kubectl expose pod"
alias kex="kubectl explain --recursive"
alias kexrs="kubectl explain replicaset"
alias kexd="kubectl explain deploy"
alias kcurr="kubectl config current-context"
alias kgc="kubectl config get-contexts"
alias kr="kubectl run"
alias ktr="kubectl run tmp --image nginx --rm --restart Never -it -- curl"
alias kaf="kubectl apply -f"
alias kcf="kubectl create -f"
alias kdf="kubectl delete -f"
alias krf="kubectl replace --force -f"
alias ksi="kubectl set image"
alias kse="kubectl set env"
alias kl="kubectl logs"
alias krhd="kubectl rollout history deploy"
alias kgpw="kubectl get deploy -w"
alias kci="kubectl cluster-info"
alias h=helm
alias hl="helm list"
alias klp="kubectl label pods -l"
alias kl="kubectl label"
alias kln="kubectl label node"
alias ktn="kubectl taint node"
alias kgenp="kubectl run nginx --image=nginx --dry-run=client -o yaml >"
alias kgend="kubectl create deployment --image=nginx nginx --replicas=4 --dry-run=client -o yaml >"
alias curr="kubectl config current-context"
alias ksd="kubectl scale deployment --replicas="
alias ksr="kubectl scale replicaset --replicas="
alias ksid="kubectl set image deployment"
alias kallp="kubectl get pods --all-namespaces"
alias ktn="kubectl top node"
alias ktp="kubectl top pod"
alias kd="kubectl drain"
alias kdi="kubectl drain --ignore-daemonsets --force"
alias ku="kubectl uncordon"
alias kc="kubectl cordon"
export do="--dry-run=client -oyaml"
export now="--grace-period=0 --force"
alias kgcsr="kubectl get csr"
alias kcap="kubectl certficate approve"
alias kcdy="kubectl certficate deny"
alias kproxy="kubectl proxy"
alias kcanic="kubectl auth can-i create"
alias kgro="kubectl get roles"
alias kgroleb="kubectl get rolebindings"
alias kdr="kubectl describe role"
alias kdrb="kubectl describe rolebindings"
alias kgro="kubectl get roles"
alias kgrowc="kubectl get roles -A --no-headers | wc -l"
alias kapins="kubectl api-resources --namespaced=true"
alias kapi="kubectl api-resources --namespaced=false"
alias kgclro="kubectl get cluster roles"
alias kgclroleb="kubectl get clusterrolebindings"
alias kcsa="kubectl create service account"
alias kgsa="kubectl get service account"
alias kgsc="kubectl get storageclass"
#key files
#etcresolv.conf - Contains nameserver can add multiple
#etcnsswitch.conf - Contains Precedence
alias nlkp="nslookup"
alias d="dig"
alias ipnsa="ip netns add"
#Networking Commands
alias ipl="ip link"
alias ipaa="ip addr add"
alias rt="route"
alias ipra="ip route add"
alias iprad="ip route add add default via"
alias hn="hostname"
